Hugo_Symbol	3'Flank	Fusion	In_Frame_Ins	Missense_Mutation	Multi_Hit_Fusion	3'UTR	total	MutatedSamples	AlteredSamples
BRAF	3	19	1	12	1	1	37	34	34
KIAA1549	0	18	0	0	0	0	18	18	18
PIK3CA	0	0	0	4	0	0	4	4	4
FGFR1	0	0	0	5	0	0	5	3	3
QKI	0	1	0	0	2	0	3	3	3
MYB	0	1	0	0	1	0	2	2	2
ROS1	0	2	0	0	0	0	2	2	2
PTPN11	0	0	0	1	0	0	1	1	1
RAF1	0	1	0	0	0	0	1	1	1
TP53	0	0	0	1	0	0	1	1	1
